111111100000000000000-
111111100000000000000-
000000000000000000000-
000011111111111110000-
000011111111111110000-
000011111111111110000-
000011111111111110000-
000000000000000000000-
000000000000000000000-
000000000000000000000